1111111111111
1000C10000001
11P00E000EP01
1111111111111