1111111111111
1000C10000001
11P00E00CEP01
1111111111111